C14   =>  C14 
O3    =>  N4  
C13   =>  C13 
O2    =>  O2  
N3    =>  N3  
C11   =>  C11 
C12   =>  C12 
C8    =>  C8  
C9    =>  C9  
C10   =>  C10 
N2    =>  N2  
H6    =>  H6  
H5    =>  H5  
N1    =>  N1  
C7    =>  C7  
O1    =>  O1  
C4    =>  C4  
C3    =>  C3  
C2    =>  C2  
C1    =>  C1  
C6    =>  C6  
C5    =>  C5  
Cl1   =>  Cl1 
H3    =>  H3  
H1    =>  H1  
H2    =>  H2  
Cl2   =>  Cl2 
H4    =>  H4  
H7    =>  H7  
H8    =>  H8  
H9    =>  H9  
H10   =>  H10 
H11   =>  C15 
