 CQ2 =>  CR2
 OQ1 =>  SR1
  C9 =>  CR4
  N4 =>   N4
  C8 =>   C8
  N1 =>   N1
 C16 =>  C16
 C10 =>  C10
 C15 =>  C15
  N3 =>   N3
  N2 =>   N2
 C19 =>  C19
 H17 =>  H15
 H15 =>  H16
 H16 =>  H17
  C6 =>   C6
 C17 =>  C17
 C11 =>  C11
 H11 =>  H11
  O2 =>   O2
 C18 =>  C18
 C14 =>   C7
 C13 =>   C5
 C12 =>  C12
  C5 =>  C13
  C7 =>  C14
  H9 =>  H12
  F2 =>   F2
 H12 =>   H9
  O3 =>   O3
 H14 =>  H14
 H18 =>  H18
 CQ1 =>  CR3
 HQ9 =>  HR7
 HQ8 =>  HR8
 HQ7 =>  HR9
 HQ2 =>  HR4
 HQ3 =>  HR5
