  N2 =>   N2
 C19 =>  C19
 H15 =>  H15
 H16 =>  H16
 H17 =>  H17
  C6 =>   C6
  O3 =>   O3
 C17 =>  C17
  O2 =>   O2
 C18 =>  C18
 C14 =>   C7
 C13 =>   C5
 C12 =>  C12
  C5 =>  C13
  C7 =>  C14
  H9 =>  H12
  F2 =>   F2
 H12 =>   H9
 C11 =>  C11
 C10 =>  C10
 C15 =>  C15
  N3 =>   N3
  C8 =>   C8
  N1 =>   N1
 C16 =>  C16
 H14 =>  H14
  N4 =>   N4
 CO1 =>  CZ3
 CO2 =>  CZ1
 HO2 =>  HZ5
 HO3 =>  HZ6
 CO3 =>  CZ4
 HO5 =>  HZ2
 HO6 =>  HZ3
 HO7 =>  HZ4
 HO1 =>  HZ1
 H18 =>  H18
 H11 =>  H11
