C15   =>  C14 
C14   =>  O3  
C13   =>  C13 
O2    =>  O2  
N3    =>  N3  
C11   =>  C11 
C12   =>  C12 
C8    =>  C8  
C9    =>  C9  
C10   =>  C10 
N2    =>  N2  
H7    =>  H6  
H6    =>  H5  
N1    =>  N1  
C7    =>  C7  
O1    =>  O1  
C4    =>  C4  
C3    =>  C3  
C2    =>  C2  
C1    =>  C1  
C6    =>  C6  
C5    =>  C5  
Cl1   =>  Cl1 
H4    =>  H3  
H2    =>  H1  
H3    =>  H2  
Cl2   =>  Cl2 
H5    =>  H4  
H8    =>  H7  
H9    =>  H8  
H11   =>  H9  
H12   =>  H10 
H13   =>  H11 
